a	ɑ
e	ɛ
i	i
o	ɔ
u	u
m	m
n 	n
ny	ɲ
ng’ 	ŋ	
mb 	mb
nd 	nd
nj	n̠d̠ʒ
ng 	ŋɡ
b 	ɓ
d 	ɗ	
j 	ɗʒ
g 	ɠ	
p 	p
t 	t
ch 	tʃ
k 	k	
p 	pʰ
t 	tʰ
ch 	tʃʰ
k 	kʰ	
mv 	ɱv		
nz 	nz			
v 	v
dh 	ð	
z 	z
gh 	ɣ	
f 	f	
th 	θ	
s 	s
sh 	ʃ	
kh 	x	
h 	h
r 	r
l 	l
y 	j	
w 	w
