african	æ f r ɪ k ə n
blacksland	b l æ k s l ə n d	
g20	jh iy t w ɛ n t i
alicetare	æ l ɪ s t ɛ r
assocaition	ə s oʊ s i eɪ ʃ ə n
associasion	ə s oʊ s i eɪ ʃ ə n
blackla	b l æ k l ə
blackslend	b l æ k s l ə n d
cabondia	k ə m b oʊ d i ə
care	k ɛ r
cc	t i s i
confidensi	k ɑ n f i d ɛ n s i j ɑ
countrt	k ʌ n t r i
culturlal	k ʌ l tʃ ɛ r ə l
face	f eɪ s
facekook	f eɪ s b ʊ k
icc	aɪ s i s i
incooperation	ɪ n k oʊ p ə
isack	aɪ z ə k
islamic	ɪ z l ɑ m i k
jackhila	dʒ æ k ɪ l
kuappreciate	k u ə p r i ʃ i eɪ t
kucooperate	k u k oʊ p ə r eɪ t
mahaplace	m ɑ t ə n p l æ s
secondari	s ɛ k ə n d ɛ r i
tucost	t u
victotria	v ɪ k t ə r i ə
wwwfbscomauswahili	d ʌ b ə l y u d ʌ b ə l y u d ʌ b ə l y u ɛ s b i eh s d ɑ t k ɑ m d ɑ t eɪ y u s w ə h i l i
lenax	l ɛ n ə k s